_template
____________________________aa____________aa____
______________________________aa________aa______
________________________________aa____aa________
__________________________________aaaa__________
__________________________________aaaaaaaaaaaaaa
________________________________aa______________
______________________________aa________________
____________________________aa__________________
__________________________aa____________________
________________________aa______________________
______________________aa________________________
________________________________________________