_template
______aa________________________________________
________aa______________________________________
__________aa__________________________________aa
____________aa______________________________aa__
______________aa__________________________aa____
________________aa______________________aa______
__________________aaaaaaaaaaaaaaaaaaaaaa________
____________________aa__________________________
______________________aa________________________
________________________aaaaaaaaaaaaaaaaaaaaaaaa
________________________________________________
________________________________________________