_template
________________________________________________
aa______________________________________________
__aa____________________________________________
____aa__________________________________________
______aa________________________________________
________aa______________________________________
aaaaaaaa__aa____________________________________
________aa__aa__________________________________
aaaaaaaaaaaa__aa________________________________
__________aaaa__aa______________________________
____________aaaa__aa____________________________
aa__________aa__aa__aa__________________________