_template
__________________________aa____aa______________
________________________aa________aa____________
______________________aa____________aa________aa
____________________aa________________aa____aa__
__________________aa____________________aaaa____
________________aa______________________aaaa____
aaaaaaaaaaaaaaaaaaaaaaaaaaaaaaaaaaaaaaaa____aaaa
aaaaaaaaaaaaaa__________________________________
________________________________________________
________________________________________________
________________________________________________
________________________________________________