_template
________________________________________________
______aaaaaaaaaaaaaaaaaaaa______________________
____aa____________________aa____________________
__aa________________________aa__aaaaaaaaaaaaaaaa
aa____________________________aa________________
________________________________aa______________
aa________________________________aa____________
__aa__________aaaaaaaaaaaaaaaaaaaaaaaa__________
____aaaa____aa________________________aa________
__________aa____________________________aa______
________aa________________________________aa____
______aa____________________________________aa__