_template
________________________________________aa__aa__
aa____________________________________aa__aa____
__aa________________________________aa__aa______
____aa____________________________aa__aa________
______aa________________________aa__aa__________
________aaaaaaaaaaaaaaaaaaaaaaaaaaaa____________
____________________________aa__________________
aaaaaa____________________aa____________________
______aa________________aa______________________
________aa____________aa________________________
__________aa________aa__________________________
____________aa____aa____________________________