000000000000000000000000000000000000000000000000
0000________________________________________0000
0000________________________________________0000
0000________________________________________0000
0000________________________________________0000
0000________________________________________0000
0000________________________________________0000
0000________________________________________0000
0000________________________________________0000
0000________________________________________0000
0000________________________________000000000000
0000________________________________________0000
0000________________________________________0000
0000________________________________________0000
0000________________________________________0000
0000________________________________________0000
0000________________________________________0000
0000________________________________________0000
0000________________________________________0000
0000________________________________________0000
0000________________________________________0000
0000________________________________________0000
0000________________________________________0000
0000000000000000000000000000________________0000