000000000000000000000000000000000000000000000000
0000____________________________________00000000
0000____________________________________00000000
0000____________0000000000000000________00000000
0000____________0000000000000000________00000000
0000____________________________________00000000
0000____________________________________00000000
0000____________0000000000000000________00000000
0000____________0000000000000000________00000000
0000____________________________________00000000
0000____________________________________00000000
0000____________________________________________
0000____________________________________________
0000____________________________________00000000
0000____________________________________00000000
0000____________________________________00000000
0000____________________________________00000000
0000____________________________________00000000
0000____________________________________00000000
0000____________________________________00000000
0000____________________________________00000000
0000____________________________________00000000
0000____________________________________00000000
0000____________________________________00000000