000000000000000000000000000000000000000000000000
0000________________________________________0000
0000________________________________________0000
0000________________________________________0000
0000________________________________________0000
0000________________________________________0000
0000____________________________________00000000
0000____________________________________00000000
0000____________________________________00000000
0000____________________________________00000000
0000____________________________________00000000
0000____________________________0000000000000000
0000____________________________0000000000000000
0000____________________________0000000000000000
0000____________________________________00000000
0000____________________________________00000000
0000____________________________________00000000
0000____________________________________00000000
0000____________________________________00000000
0000________________________________________0000
0000________________________________________0000
0000________________________________________0000
0000________________________________________0000
0000________________________________________0000