000000000000000000000000000000000000000000000000
0000________________________________________0000
0000________________________________________0000
0000________________________________________0000
0000________________________________000000000000
0000________________________________000000000000
0000________________________________________0000
0000____________________________0301________0000
0000____________________________0401________0000
0000________________________________0301____0000
0000________________________________0401____0000
0000________________________________________0000
0000________________________________0501____0000
0000________________________________0601____0000
0000____________________________0501________0000
0000____________________________0601________0000
0000________________________________________0000
0000________________________________000000000000
0000________________________________000000000000
0000________________________________________0000
0000________________________________________0000
0000________________________________________0000
0000________________________________________0000
0000000000000000000000000000________________0000