000000000000000000000000000000000000000000000000
0000____________________________________00000000
0000____________________________________00000000
0000________________________00000000____00000000
0000________________________00000000____00000000
0000____________________________________00000000
0000________00000000____________________00000000
0000________00000000____________________00000000
0000____________________________________________
0000____________________________________________
0000____________________________________00000000
0000____________________________________00000000
0000____________________________________00000000
0000____________________________________00000000
0000____________________________________00000000
0000____________00000000________________00000000
0000____________00000000________________00000000
0000____________________________________00000000
0000____________________________________00000000
0000________________________00000000____00000000
0000________________________00000000____00000000
0000____________________________________00000000
0000____________________________________00000000
0000____________________________________00000000