000000000000000000000000000000000000000000000000
00000000____________________________________0000
00000000____________________________________0000
00000000____________________________________0000
00000000____________________________________0000
00000000____________________________________0000
00000000____________________________________0000
00000000____________________________________0000
00000000____________________________________0000
00000000____________________________________0000
00000000____________________________________0000
00000000____________________________________0000
00000000____________________________________0000
00000000____________________________________0000
00000000____________________________________0000
00000000____________________________________0000
00000000____________________________________0000
00000000____________________________________0000
00000000____________________________________0000
00000000____________________________________0000
00000000____________________________________0000
00000000____________________________________0000
00000000____________________________________0000
000000000000000000000000000000000000________0000