000000000000000000000000000000000000000000000000
000000000000000000000000000000000000000000000000
000000000000000000000000000000000000000000000000
0000000000000000____________________________0000
0000000000000000000000000000000000000000____0000
0000000000000000000000000000000000000000____0000
0000000000000000000000000000000000000000____0000
0000________________________________________0000
0000________________________________________0000
0000________________________________________0000
0000________________________________________0000
0000________________________________________0000
0000________________________________________0000
0000________________________________________0000
0000________________________________________0000
0000________________________________________0000
0000________________________________________0000
0000________________________________________0000
0000________________________________________0000
0000________________________________________0000
0000________________________________________0000
0000________________________________________0000
0000________________________________________0000
0000________________________________________0000