000000000000000000000000000000000000000000000000
000000000000000000000000000000000000000000000000
000000000000000000000000000000000000000000000000
000000000000000000000000000000000000000000000000
000000000000000000000000000000000000000000000000
000000000000000000000000000000000000000000000000
000000000000000000000000000000000000000000000000
000000000000000000000000000000000000000000000000
000000000000000000000000000000000000000000000000
000000000000000000000000000000000000000000000000
000000000000000000000000000000000000000000000000
________________________________________00000000
________________________________________00000000
00000000000000000000000000000000________00000000
00000000000000000000000000000000________00000000
00000000000000000000000000000000________00000000
00000000000000000000000000000000________00000000
00000000000000000000000000000000________00000000
00000000000000000000000000000000________00000000
00000000000000000000000000000000________00000000
00000000000000000000000000000000________00000000
00000000000000000000000000000000________00000000
00000000000000000000000000000000________00000000
00000000000000000000000000000000________00000000