000000000000000000000000000000000000000000000000
000000000000000000000000000000000000000000000000
000000000000000000000000000000000000000000000000
000000000000000000000000000000000000000000000000
000000000000000000000000000000000000000000000000
000000000000000000000000000000000000000000000000
000000000000000000000000000000000000000000000000
000000000000000000000000000000000000000000000000
____________000000000000000000000000000000000000
____________000000000000000000000000000000000000
0000________000000000000000000000000000000000000
0000____________________________________00000000
0000____________________________________00000000
00000000000000000000000000000000________00000000
00000000000000000000000000000000________00000000
00000000000000000000000000000000________00000000
00000000000000000000000000000000________00000000
00000000000000000000000000000000________00000000
00000000000000000000000000000000________00000000
00000000000000000000000000000000________00000000
00000000000000000000000000000000________00000000
00000000000000000000000000000000________00000000
00000000000000000000000000000000________00000000
00000000000000000000000000000000________00000000