0000________________________________________0000
0000________________________________________0000
0000________________________________________0000
0000________________________________________0000
0000________________________________________0000
0000________________________________________0000
0000________________________________________0000
0000________________________________________0000
0000________________________________________0000
0000________________________________________0000
0000________________________________________0000
0000________________________________________0000
0000________________________________________0000
0000________________________________________0000
0000________________0000____________________0000
0000________________0000____________________0000
0000________________0000____________________0000
0000________________0000____________________0000
0000________________00000000000000000000____0000
0000________________________________________0000
0000________________________________________0000
0000________________________________________0000
0000________________________________________0000
000000000000000000000000000000000000000000000000