0000000000000000000000000000________________0000
0000________________________________________0000
0000________________________________________0000
0000________________________________________0000
0000________________________________________0000
0000________________________________________0000
0000________________________________________0000
0000________________________________________0000
0000________________________________________0000
0000________________________________________0000
0000________________________________________0000
0000________________________________________0000
0000________0000____________________________0000
0000________0000____________________________0000
0000________0000____________________________0000
0000________0000____________________________0000
0000________0000____________________________0000
0000________0000____________________________0000
0000________0000000000000000000000000000____0000
0000________________________________________0000
0000________________________________________0000
0000________________________________________0000
0000________________________________________0000
000000000000000000000000000000000000000000000000