000000000000000000000000000000000000____00000000
00000000________________________________00000000
00000000________________________________00000000
00000000____________________________000000000000
00000000________________________________00000000
00000000________________________________00000000
00000000________________________________00000000
00000000________________________________00000000
00000000________________________________00000000
00000000________________________________00000000
00000000________________________________00000000
00000000________________________________00000000
00000000________________________________00000000
00000000________________________________00000000
00000000____________________________000000000000
00000000________________________________00000000
00000000________________________________00000000
00000000________________________________00000000
00000000________________________________00000000
00000000________________________________00000000
00000000________________________________00000000
00000000________________________________00000000
00000000________________________________00000000
000000000000000000000000000000000000000000000000