000000000000000000000000000000000000____00000000
00000000________________________________00000000
00000000________________________________00000000
00000000____________________0000________00000000
00000000____________________0000________00000000
00000000____________________0000________00000000
00000000____________________0000________00000000
00000000____________________0000________00000000
00000000____________________0000________00000000
00000000____________________0000________00000000
00000000____________________0000________00000000
00000000____________________0000________00000000
00000000____________________0000________00000000
00000000____________________0000________00000000
00000000____________________0000________00000000
00000000____________________0000________00000000
00000000____________________0000________00000000
00000000____________________0000________00000000
00000000____________________0000________00000000
00000000____________________0000________00000000
00000000____________________0000________00000000
00000000________________________________00000000
00000000________________________________00000000
000000000000000000000000000000000000000000000000