000000000000000000000000000000000000________0000
00000000____________________________________0000
00000000____________________________________0000
00000000____________________________________0000
00000000____________________________________0000
00000000____________________________________0000
00000000____________________________________0000
00000000____________________________________0000
00000000____________00000000________000000000000
00000000____________00000000________000000000000
00000000____________________________________0000
00000000____________________________________0000
00000000____________________________________0000
00000000____________________________________0000
00000000____________________________________0000
00000000____________________00000000________0000
00000000____________________00000000________0000
00000000____________________________________0000
00000000____________________________________0000
0000000000000000____________________________0000
0000000000000000____________________________0000
00000000____________________________________0000
00000000____________________________000000000000
00000000____________________________000000000000