00000000000000000000000000000000________00000000
00000000000000000000000000000000________00000000
0000000000000000000000000000____________00000000
0000000000000000000000000000____________00000000
000000000000000000000000________________00000000
00000000000000000000____________________00000000
00000000000000000000____________________00000000
00000000000000000000____________________00000000
00000000000000000000____________________00000000
00000000000000000000____________________00000000
0000000000000000________________________00000000
0000000000000000________________________00000000
0000000000000000________________________00000000
00000000000000000000____________________00000000
00000000000000000000____________________00000000
00000000000000000000____________________00000000
00000000000000000000____________________00000000
000000000000000000000000________________00000000
000000000000000000000000________________00000000
000000000000000000000000________________00000000
000000000000000000000000________________00000000
0000000000000000000000000000____________00000000
00000000000000000000000000000000________00000000
000000000000000000000000000000000000____00000000