00000000________________________________00000000
00000000________________________________00000000
00000000____________________00000000000000000000
00000000____________________00000000000000000000
00000000________________________________00000000
00000000________________________________00000000
00000000________________________________00000000
00000000________________________________00000000
00000000________________000000000000000000000000
00000000________________000000000000000000000000
00000000________________________________00000000
00000000________________________________00000000
00000000________________________________00000000
00000000________________________________00000000
00000000____________0000000000000000000000000000
00000000____________0000000000000000000000000000
00000000________________________________00000000
00000000________________________________00000000
00000000________________________________00000000
00000000________________________________00000000
00000000____________0000000000000000000000000000
00000000____________0000000000000000000000000000
00000000____________0000000000000000000000000000
00000000____________0000000000000000000000000000