00000000____________________________________0000
00000000____________________________________0000
00000000____________________________________0000
00000000____________________________________0000
00000000____________00000000________________0000
00000000____________00000000________________0000
00000000____________________________________0000
00000000____________________________________0000
00000000____________________________000000000000
00000000____________________________000000000000
00000000____________________________________0000
00000000____________________________________0000
00000000____________0000000000000000000000000000
00000000____________0000000000000000000000000000
00000000____________0000000000000000000000000000
00000000____________0000000000000000000000000000
00000000____________0000000000000000000000000000
00000000____________________________________0000
00000000____________________________________0000
00000000____________________________________0000
0000000000000000000000000000000000000000____0000
0000000000000000000000000000000000000000____0000
0000000000000000000000000000000000000000____0000
0000000000000000000000000000000000000000____0000