00000000____________0000000000000000000000000000
00000000____________0000000000000000000000000000
00000000____________0000000000000000000000000000
00000000____________0000000000000000000000000000
00000000____________0000000000000000000000000000
00000000________________________0000000000000000
00000000________________________0000000000000000
00000000____________0000000000000000000000000000
00000000____________0000000000000000000000000000
00000000________________________0000000000000000
00000000________________________0000000000000000
00000000____________0000000000000000000000000000
00000000____________0000000000000000000000000000
00000000________________________0000000000000000
00000000________________________0000000000000000
00000000____________0000000000000000000000000000
00000000____________0000000000000000000000000000
00000000________________________________________
00000000________________________________________
00000000________________________________________
00000000________________________________________
000000000000000000000000000000000000000000000000
000000000000000000000000000000000000000000000000
000000000000000000000000000000000000000000000000