0000000000000000000000000000000000000000____0000
000000000000000000000000000000000000000000000000
00000000____________________________________0000
00000000____________________________________0000
00000000____________________________________0000
00000000____________________________________0000
00000000____________________________________0000
00000000____________00000000________________0000
00000000____________00000000________________0000
00000000____________00000000________________0000
00000000____________00000000________________0000
00000000____________00000000________________0000
00000000____________00000000________________0000
00000000____________0000000000000000________0000
00000000____________0000000000000000________0000
00000000____________00000000________________0000
00000000____________00000000________________0000
____________________00000000________________0000
____________________00000000________________0000
____________________00000000________________0000
____________________00000000________________0000
000000000000000000000000000000000000000000000000
000000000000000000000000000000000000000000000000
000000000000000000000000000000000000000000000000