00000000________00000000000000000000000000000000
00000000________00000000000000000000000000000000
00000000________________________0000____________
00000000________________________0000____________
00000000________________________0000____________
00000000________________________0000____________
00000000________________________0000____________
00000000________________________0000____________
00000000________________________0000____________
00000000________________________0000____________
00000000________________________0000____________
00000000________________________0000____________
00000000________________________0000____________
00000000________________________0000____________
00000000________________________0000____________
00000000________________________0000____________
00000000________________________0000____________
00000000________________________0000____________
00000000________________________0000____________
00000000________________________0000____________
00000000________________________0000____________
00000000________________________0000____________
00000000________________________0000____________
000000000000000000000000000000000000000000000000