_template
________________________________________________
________________________________________________
________________________________________________
__________aa__aa________________________________
__________aa__aa________________________________
__________aa__aa____aa__________________________
__________aa__aa____aa__________________________
__________aa__aa____aa__________________________
__________aa__aaaaaaaaaaaa______________________
__________aa________aa__________________________
____________________aa__________________________
________________________________________________