_template
aaaaaaaaaaaaaaaaaaaaaaaaaaaaaaaaaaaaaaaaaaaaaaaa
aa____________________________________________aa
aa______________________aa____________________aa
aa______________________aa____________________aa
aa______________________aa______aa____________aa
aa______________________aa______aa____________aa
aa______________________aa______aa____________aa
aa______________________aaaaaaaaaaaaaaaa______aa
aa______________________________aa____________aa
aa______________________________aa____________aa
aa____________________________________________aa
aaaaaaaaaaaaaaaaaaaaaaaaaaaaaaaaaaaaaaaaaaaaaaaa