_template
________________________________________________
________________________________________________
________aa______________________________________
__________aa________aaaaaaaaaaaa________________
__________aa________aa________aa________________
____________________aa________aa________________
__________aa________aa________aa________________
__________aa________aa________aa________________
__________aa________aa________aa________________
__________aa________aaaaaaaaaaaaaaaa____________
________________________________________________
________________________________________________