_template
________________________________________________
________________________________________________
____________________aaaaaa______________________
______________aa__aa____________________________
______________aa__aa____________________________
______________aa__aa____________________________
______________aa__aaaaaaaa______________________
______________aa__aa____aa______________________
______________aa__aa____aa______________________
______________aa__aaaaaaaa______________________
________________________________________________
________________________________________________