000000000002000300040005000600070008000900100011
010001010102010301040105010601070108010901100111
020002010202020302040205020602070208020902100211
030003010302030303040305030603070308030903100311
040004010402040304040405040604070408040904100411
050005010502050305040505050605070508050905100511
060006010602060306040605060606070608060906100611
070007010702070307040705070607070708070907100711
080008010802080308040805080608070808080908100811
090009010902090309040905090609070908090909100911
100010011002100310041005100610071008100910101011
110011011102110311041105110611071108110911101111
120012011202120312041205120612071208120912101211
130013011302130313041305130613071308130913101311
140014011402140314041405140614071408140914101411
150015011502150315041505150615071508150915101511
160016011602160316041605160616071608160916101611
170017011702170317041705170617071708170917101711
180018011802180318041805180618071808180918101811
190019011902190319041905190619071908190919101911
200020012002200320042005200620072008200920102011
210021012102210321042105210621072108210921102111
220022012202220322042205220622072208220922102211
230023012302230323042305230623072308230923102311