_collision
aaaaaaaaaaaaaaaaaaaaaaaaaaaaaaaaaaaaaaaaaaaaaaaa
aa____________________________________________aa
aa____________________________________________aa
aa____________________________________________aa
aa____________________________________________aa
aa____________________________________________aa
aa__________________ac________________________aa
aa____________________ac______________________aa
aa______________________ac____________________aa
aaaaaaaaaaaaaaaaaaaaaaaaaaaaaaaaaaaaaaaaaaaaaaaa
aaaaaaaaaaaaaaaaaaaaaaaaaaaaaaaaaaaaaaaaaaaaaaaa
aaaaaaaaaaaaaaaaaaaaaaaaaaaaaaaaaaaaaaaaaaaaaaaa