_collision
aaaaaaaaaaaaaaaaaaaaaaaaaaaaaaaaaaaaaaaaaaaaaaaa
aa____________________________________________aa
aa____________________________________________aa
aa____________________________________________aa
aa________________________ef__________________aa
aa__________ff________ef__ff____________ef____aa
aa______ff________ef__ff____________ef________aa
aa__ff____________ff____________ef____________aa
aa____________________________________________aa
aaaaaaaaaaaaaaaaaaaaaaaaaaaaaaaaaaaaaaaaaaaaaaaa
aaaaaaaaaaaaaaaaaaaaaaaaaaaaaaaaaaaaaaaaaaaaaaaa
aaaaaaaaaaaaaaaaaaaaaaaaaaaaaaaaaaaaaaaaaaaaaaaa