_template
________________________________________________
__________________aaaaaaaaaaaaaaaa______________
________________aa________________aa____________
______________aa____________________aa__________
____________aa________________________aa________
__________aa____________________________aa______
________aa________________________________aa____
______aa____________________________________aa__
____aa________________________________________aa
__aa____________________________________________
aa______________________________________________
aa______________________________________________