_template
______________________aaaaaaaaaaaaaaaa__________
____________________aa________________aa________
__________________aa____________________aa______
________________aa________________________aa____
______________aa____________________________aa__
____________aa________________________________aa
__________aa____________________________________
________aa______________________________________
______aa________________________________________
____aa__________________________________________
__aa____________________________________________
aa______________________________________________