_template
__________aa______________aa____________________
________aa__________________aa__________________
______aa______________________aa________________
____aa__________________________aa______________
__aa______________________________aa____________
aa__________________________________aa__________
______________________________________aa________
________________________________________aa______
__________________________________________aa____
____________________________________________aa__
______________________________________________aa
________________________________________________