_template
________________________________________________
________________________________________________
________________________aa______________________
________________aa______aa______________________
________________aa______aa______________________
________________aa______aa______________________
________________aa______aa______________________
________________aa______aa______________________
________________aa______aa______________________
________________aa______aa______________________
________________aa______________________________
________________________________________________