_template
__________________aa____________________________
__________________aa____________________________
__________________aa____________________________
__________________aa____________________________
__________________aa____________________________
__________________aa____________________________
__________________aa____________________________
aaaaaaaaaaaaaaaaaaaa____________________________
__________________________aaaaaaaaaaaa__________
________________________aa____________aa________
______________________aa________________aa______
____________________aa____________________aa____