_template
________________________________________________
________________________________________________
__________aaaaaaaaaaaaaaaaaaaaaa________________
________aa______________________aa______________
______aa__________________________aaaaaaaaaaaaaa
____aa__________________________aa__aa__________
__aa__________________________aa______aa______aa
__aa________________________aa__________aa__aa__
__aa______________________aa______________aa____
__aa____________________aa______________aa__aa__
__aa__________________aa______________aa______aa
__aa________________aa______________aa__________