_template
__aa________aa____aa__aa________________________
aa__________aa______aa__aa______________________
____________aa________aa__aa____________________
__________aa____________aa__aa__________________
________aa________________aa__aa________________
______aa____________________aa__aa______________
____aa________________________aaaaaaaaaaaaaaaaaa
__aa________________________________aaaaaaaaaaaa
aa______________________________________________
________________________________________________
________________________________________________
____________aaaaaaaaaaaaaaaaaaaaaaaa____________