_template
__________aa________________________aa__________
________aa____________________________aa________
______aa________________________________aa______
____aa____________________________________aa____
aaaaaaaaaaaaaaaaaaaaaaaaaa__________________aa__
aa________________________aa__________________aa
____________________________aa______________aa__
______________________________aa__________aa____
________________________________aa______aa______
__________________________________aa__aa________
____________________________________aa__________
aa________________________________aa__aa________