_template
__aa____________________________aa______aa______
____aa________________________aa__________aa____
______aa____________________aa______________aa__
________aa________________aa__________________aa
__________aa____________aa__________________aa__
____________aa________aa__________________aa____
______________aaaaaaaaaaaaaaaaaaaaaaaaaaaa______
__________________aa____________________________
________________aa______________________________
______________aa________________________________
____________aa__________________________________
aaaaaaaaaaaa____________________________________