level2
________________________________________________
________________________________________________
____aa__aa________________aa____________________
____aa__aa________________aa____________________
____aa__aa__aaaa__aa__aa__aa____________________
____aaaaaa__aa____aa__aa__aa____________________
____aa__aa__aaaa____aa____aa____________________
____aa__aa__aa______aa__________________________
____aa__aa__aaaa____aa____aa____________________
________________________________________________
________________________________________________
________________________________________________