bbbb____________________________________________
________________________________________________
______________bd____bd__________________________
______________bd____bd__________________________
______________bd____bd__bd______________________
______________bdbdbdbd__________________________
______________bd____bd__bd______________________
______________bd____bd__bd______________________
______________bd____bd__bd__bd__________________
________________________________________________
________________________________________________
________________________________________________