img/test/level2.png
caca____________________________________________
________________________________________________
______________ca____ca__________________________
______________ca____ca__________________________
______________ca____ca__ca______________________
______________cacacaca__________________________
______________ca____ca__ca______________________
______________ca____ca__ca______________________
______________ca____ca__ca__ca__________________
________________________________________________
________________________________________________
________________________________________________