_template
____________________________aa__________________
__________________________aa____________________
________________________aa____________________aa
______________________aa____________________aa__
____________________aa____________________aa____
____________________aa__________________aa______
____________________aa________________aa________
______________________aa____________aa__________
________________________aa________aa____________
__________________________aa____aa______________
____________________________aaaa________________
____________________________aaaa________________