level
________________________________________________
__aa____aa______________________________________
__aa____aa______________________________________
__aa____aa__aa__________________________________
__aaaaaaaa______________________________________
__aa____aa__aa__________________________________
__aa____aa__aa__________________________________
__aa____aa__aa__________________________________
__aa____aa__aa__aa______________________________
________________________________________________
________________________________________________
________________________________________________