img/test/level.png
________________________________________________
____aa__aa______________________________________
____aa__aa__aa__________________________________
____aa__aa______________________________________
____aaaaaa__aa__________________________________
____aa__aa__aa__________________________________
____aa__aa__aa__________________________________
____aa__aa__aa__aa______________________________
________________________________________________
________________________________________________
________________________________________________
_________________________________________________