img/test/level.png
aaaa____________________________________________
________________________________________________
________aa__aa__________________________________
________aa__aa__________________________________
________aa__aa__aaaaaa__________________________
__________aa____aa__aa__________________________
__________aa____aa__aa__________________________
__________aa____aaaaaa__aa______________________
________________________________________________
________________________________________________
________________________________________________
_________________________________________________